XXXXXXXX
X......X
T.GXX..X
X.SXS.XX
XKXXXKXX