XSXXXXTX
X......X
X......X
X..CC..X
X......X
XJ....JP
XXDXXXXX
-
T 3, S