XXTXXXXX
X.....JX
XJ.....X
S......C
P......X
X......C
XDXXXXXX
-
T 3, S