XXXXX
XJ..X
X...X
X...X
XXDXX
