XXXXSXXXX
X.......X
T.......X
X...J...X
X.......C
X.......X
XXXXDXPXX