XXXTX
X...X
X.J.X
X...X
XXDXX
-
T, S