XXXXX
XH..X
X...X
X...X
XXDXX
