XSXXTX
X....X
X.CC.X
XJ..JX
XXDXXX
-
T, S