XSXXTX
X....X
X.CC.X
XJ...X
XXDXXX
