XXXXSXXXX
XX......X
XX.X.XX.X
T..XXXXJX
X.X.X.X.C
X.......X
XXXDXXXXX
-
T