XtXXsX
X.J..X
X.CC.X
X....X
XXDXXX
