XXXXsXXXX
X.......X
t.......X
X...J...X
X.......C
X.......X
XXvXDXpXX