XXTPCXXXXXX
D.........X
XXXXXXXXX.X
XXJ....X..X
X..XJX...SX
XXXXXXXXXXX
-
T 3, S