XXXTX
XJ..X
X...X
XJ..X
XXDXX
-
T